0000000000000000!
1110111100111000!
0011100100101100!
0000000100100100!
0011111100100100!
0010000000100111!
0011111111100000!
0000000000000000!